5 20 2
1 1
18 3
1 1 2 5 2 0.5833 16 3 0.4167
1 3 2 5 2 0.6875 16 3 0.3125
XXXXXXXXXXXXXXXXXXXX
X___X______X___X___X
XXX________X_X___X_X
X___X________X_X_X_X
XXXXXXXXXXXXXXXXXXXX
